1111111111
1P00000001
1010111101
1C001000E1
1010111001
1111111111