1111111111111111111111111
1P00000000000000000000001
1111011110111101111011111
1C00100001000000000100001
1011011101111011101110111
1000010000000000001000001
1111010111101111010111011
1C000000C00010000C00000E1
1111111111111111111111111